APERTA-RUÃO - Piper aduncum L.
APERTA-RUÃO - Piper mollicomum Kunth
ARECA-BAMBU - Dypsis lutescens (H.Wendl.) Beentje & J.Dransf.
BANANA-PRATA - Musa paradisica L.
BIGODE-DE-OURO - Callisia fragrans (Lindl.) Woodson
BOLDO-JAPONÊS - Plectranthus neochilus Schltr.
BOTÃO-DE-OURO - Unxia suffruticosa (Baker) Stuessy
BROMIL - Senega paniculata (L.) J.F.B.Pastore & J.R.Abbott
CAMABARÁ-BRANCO - Lantana nivea Vent.
CAMARÃO-VERMELHO - Justicia brandegeeana Wassh. & L.B.Sm.
CAPIM-LIMÃO RASTEIRO - Pectis brevipedunculata Sch.Bip.
CHAMBÁ - Justicia pectoralis Jacq.
CHEFLERA - Heptapleurum actinophyllum (Endl.) Lowry & G.M. Plunkett
CHIFRE-DE-VEADO - Platycerium bifurcatum (Cav.) C. Chr.
CINERÁRIA - Jacobaea maritima (L.) Pelser & Meijden
CIPÓ-CABELUDO - Mikania hirsutissima DC.
CÓLEUS - Coleus scutellarioides (L.) Benth.
COPAÍBA - Copaifera langsdorffi Desf.
COTONETE - Clerodendrum quadriloculare (Blanco) Merr.
CRAJIRU - Quimiotipo 1 - Fridericia chica var. angustifolia (Bonpl.) L.G.Lohmann
CRAJIRU - Quimiotipo 2 - Fridericia chica (Bonpl.) L.G.Lohmann
CRAJIRU - Quimiotipo 3 - Fridericia chica (Bonpl.) L.G.Lohmann
CRAJIRU - Quimiotipo 4 - Fridericia chica (Bonpl.) L.G.Lohmann
CROTALÁRIA - Crotalaria ochroleuca G. Don
DENTE-DE-LEÃO - Taraxacum officinale F.H. Wigg.
ELEVANTE - Mentha citrata L.
ELIXIR-PAREGORICO - Piper callosum Ruiz & Pav.
EUCALIPTO - Eucalyptus globulus Labill.
FAVA-DE-ARIDAN - Tetrapleura tetraptera (Schum. & Thonn.) Taub.
FAVELA - Cnidoscolus quercifolia Pohl
FEIJÃO-AZUL - Clitoria ternatea L.
HORTELÃ - Mentha crispa L.
HORTELÃ-PIMENTA - Coleus amboinicus Lour.
HORTELÃ-PIMENTA-VARIEGATA - Coleus amboinicus Lour.
INFALIVINA - Calea pinnatifida (R.Br.) Banks ex Steud.
INSULINA 1 - Cissus sulcicaulis (Baker) Planch.
JABOTICABA - Plinia peruviana (Poir.) Govaerts
JANAÚBA - Euphorbia umbellata (Pax) Bruyns
MACASSÁ - Aeollanthus suaveolens Mart. ex Spreng.
MARIANEIRA - Iochroma arborescens (L.) J.M.H. Shaw
MASTRUÇO - Coronopus didymus (L.) Sm.
MELISSA - Melissa officinalis L.
MENTA - Mentha sp.
QUEBRA-PEDRA - Moeroris amara (Schumach. & Thonn.)
QUEBRA-PEDRA-RASTEIRO - Euphorbia prostata Aiton
RABO-DE-BUGIO - Dalbergia frutescens (Vell.) Britton